................#.........
#........####...@....@...@
@...@...@@@@@@@......###..
.........@###########...@.
@#........@#.......@#.....
....#########..@.#........
